6 6 6 6 6 6 6 6 6 6 6 6 6 6 6 6 6 6 6 6 6 6 6 6 6 6 6 6 6 6 6 6 6 6 6 6 6 6 6 6 6 6 6 6 6 6 6 6 6 6 
6 0 0 0 0 0 0 0 0 0 0 0 0 0 0 0 0 0 0 0 0 0 0 0 0 0 0 0 0 0 0 0 0 0 0 0 0 0 0 0 0 0 0 0 0 0 0 0 0 6 
6 0 0 0 0 0 0 6 0 0 0 0 0 0 0 0 0 0 0 6 11 6 6 6 6 6 6 6 6 11 6 0 0 0 0 0 0 0 0 0 0 0 6 9 0 0 0 0 0 6 
6 0 0 0 0 0 6 6 7 0 0 0 6 6 6 6 6 6 6 6 0 0 0 0 0 0 0 0 0 0 6 6 6 6 6 6 6 6 0 0 0 7 6 6 0 0 0 0 0 6 
6 0 0 0 0 0 6 7 7 0 6 6 6 7 7 7 0 0 0 0 0 0 6 0 0 0 0 6 0 0 0 0 0 0 7 7 7 6 6 6 0 7 7 6 0 0 0 0 0 6 
6 0 0 0 0 0 0 0 0 6 6 0 0 0 0 0 0 0 0 0 0 0 6 0 0 0 0 6 0 0 0 0 0 0 0 0 0 0 0 6 6 0 0 0 0 0 0 0 0 6 
6 0 10 6 6 0 0 0 0 6 0 0 0 8 0 0 0 0 0 0 6 6 6 0 0 0 0 6 6 6 0 0 0 0 0 0 8 0 0 0 6 0 0 0 0 6 6 10 0 6 
6 0 6 6 7 0 0 0 0 6 6 0 0 0 0 0 0 0 0 0 0 0 0 0 0 0 0 0 0 0 0 0 0 0 0 0 0 0 0 6 6 0 0 0 0 7 6 6 0 6 
6 0 0 7 7 0 0 0 0 0 6 6 0 0 6 6 6 6 12 6 6 6 6 0 0 0 0 6 6 6 6 12 6 6 6 6 0 0 6 6 0 0 0 0 0 7 7 0 0 6 
6 0 0 0 0 6 6 6 0 0 0 6 6 6 6 15 0 0 0 0 0 0 6 6 6 6 6 6 0 0 0 0 0 0 15 6 6 6 6 0 0 0 6 6 6 0 0 0 0 6 
6 0 0 0 6 6 0 6 6 0 0 0 0 0 0 0 0 0 0 0 0 0 0 0 6 6 0 0 0 0 0 0 0 0 0 0 0 0 0 0 0 6 6 0 6 6 0 0 0 6 
6 0 0 0 6 0 0 0 6 6 0 0 0 0 0 0 0 0 0 0 0 0 0 0 0 0 0 0 0 0 0 0 0 0 0 0 0 0 0 0 6 6 0 0 0 6 0 0 0 6 
6 0 0 6 6 0 0 0 0 6 0 0 1 0 0 0 7 7 6 6 6 14 6 6 6 6 6 6 6 6 6 6 7 7 0 0 0 2 0 0 6 0 0 0 0 6 6 0 0 6 
6 0 0 6 7 0 0 0 0 6 0 0 0 0 0 0 7 6 6 0 0 0 0 0 0 0 0 0 0 0 0 6 6 7 0 0 0 0 0 0 6 0 0 8 0 7 6 0 0 6 
6 0 0 6 7 0 0 0 6 6 0 0 0 0 0 0 6 6 0 0 0 0 0 0 0 0 0 0 0 0 0 0 6 6 0 0 0 0 0 0 6 6 0 0 0 7 6 0 0 6 
6 0 0 6 7 0 0 0 6 15 0 0 0 0 0 6 6 0 0 0 0 0 0 0 6 6 0 0 0 0 0 0 0 6 6 0 0 0 0 0 15 6 0 0 0 7 6 0 0 6 
6 0 0 6 0 0 0 0 6 0 0 0 7 7 6 6 8 0 0 0 7 7 7 0 6 6 0 7 7 7 0 0 0 8 6 6 7 7 0 0 0 6 0 0 0 0 6 0 0 6 
6 0 0 6 0 0 0 0 6 0 0 0 7 6 6 0 0 0 0 7 7 0 0 0 6 6 0 0 0 7 7 0 0 0 0 6 6 7 0 0 0 6 0 0 0 0 6 0 0 6 
6 0 0 6 0 0 0 0 12 0 0 0 6 6 0 0 0 0 7 7 0 0 0 0 0 0 0 0 0 0 7 7 0 0 0 0 6 6 0 0 0 13 0 0 0 0 6 0 0 6 
6 0 6 6 0 0 0 0 6 0 0 0 6 0 0 0 0 7 7 0 0 0 0 0 5 0 0 0 0 0 0 7 7 0 0 0 0 6 0 0 0 6 0 0 0 0 6 6 0 6 
6 0 11 0 0 0 6 0 6 0 0 0 6 0 0 0 7 7 0 0 0 0 0 0 0 0 0 0 0 0 0 0 7 7 0 0 0 6 0 0 0 6 0 6 0 0 0 11 0 6 
6 0 6 0 0 0 6 0 6 0 0 0 11 0 0 0 7 0 0 0 0 0 0 0 6 6 0 0 0 0 0 0 0 7 0 0 0 11 0 0 0 6 0 6 0 0 0 6 0 6 
6 0 6 0 6 6 6 0 6 6 0 0 6 0 0 0 7 0 0 0 0 0 0 0 6 6 0 0 0 0 0 0 0 7 0 0 0 6 0 0 6 6 0 6 6 6 0 6 0 6 
6 0 6 0 0 0 0 0 0 6 0 0 6 0 0 0 0 0 0 0 0 0 0 0 6 6 0 0 0 0 0 0 0 0 0 0 0 6 0 0 6 0 0 0 0 0 0 6 0 6 
6 0 6 0 0 0 0 0 0 6 6 0 6 0 0 6 6 6 0 0 0 6 6 6 6 6 6 6 6 0 0 0 6 6 6 0 0 6 0 6 6 0 0 0 0 0 0 6 0 6 
6 0 6 0 0 0 0 0 0 6 6 0 6 0 0 6 6 6 0 0 0 6 6 6 6 6 6 6 6 0 0 0 6 6 6 0 0 6 0 6 6 0 0 0 0 0 0 6 0 6 
6 0 6 0 0 0 0 0 0 6 0 0 6 0 0 0 0 0 0 0 0 0 0 0 6 6 0 0 0 0 0 0 0 0 0 0 0 6 0 0 6 0 0 0 0 0 0 6 0 6 
6 0 6 0 6 6 6 0 6 6 0 0 6 0 0 0 7 0 0 0 0 0 0 0 6 6 0 0 0 0 0 0 0 7 0 0 0 6 0 0 6 6 0 6 6 6 0 6 0 6 
6 0 6 0 0 0 6 0 6 0 0 0 11 0 0 0 7 0 0 0 0 0 0 0 6 6 0 0 0 0 0 0 0 7 0 0 0 11 0 0 0 6 0 6 0 0 0 6 0 6 
6 0 11 0 0 0 6 0 6 0 0 0 6 0 0 0 7 7 0 0 0 0 0 0 0 0 0 0 0 0 0 0 7 7 0 0 0 6 0 0 0 6 0 6 0 0 0 11 0 6 
6 0 6 6 0 0 0 0 6 0 0 0 6 0 0 0 0 7 7 0 0 0 0 0 0 0 0 0 0 0 0 7 7 0 0 0 0 6 0 0 0 6 0 0 0 0 6 6 0 6 
6 0 0 6 0 0 0 0 12 0 0 0 6 6 0 0 0 0 7 7 0 0 0 0 0 0 0 0 0 0 7 7 0 0 0 0 6 6 0 0 0 13 0 0 0 0 6 0 0 6 
6 0 0 6 0 0 0 0 6 0 0 0 7 6 6 0 0 0 0 7 7 0 0 0 6 6 0 0 0 7 7 0 0 0 0 6 6 7 0 0 0 6 0 0 0 0 6 0 0 6 
6 0 0 6 0 0 0 0 6 0 0 0 7 7 6 6 8 0 0 0 7 7 7 0 6 6 0 7 7 7 0 0 0 8 6 6 7 7 0 0 0 6 0 0 0 0 6 0 0 6 
6 0 0 6 7 0 0 0 6 15 0 0 0 0 0 6 6 0 0 0 0 0 0 0 6 6 0 0 0 0 0 0 0 6 6 0 0 0 0 0 15 6 0 0 0 7 6 0 0 6 
6 0 0 6 7 0 0 0 6 6 0 0 0 0 0 0 6 6 0 0 0 0 0 0 0 0 0 0 0 0 0 0 6 6 0 0 0 0 0 0 6 6 0 0 0 7 6 0 0 6 
6 0 0 6 7 0 8 0 0 6 0 0 0 0 0 0 7 6 6 0 0 0 0 0 0 0 0 0 0 0 0 6 6 7 0 0 0 0 0 0 6 0 0 0 0 7 6 0 0 6 
6 0 0 6 6 0 0 0 0 6 0 0 3 0 0 0 7 7 6 6 6 6 6 6 6 6 6 6 14 6 6 6 7 7 0 0 0 4 0 0 6 0 0 0 0 6 6 0 0 6 
6 0 0 0 6 0 0 0 6 6 0 0 0 0 0 0 0 0 0 0 0 0 0 0 0 0 0 0 0 0 0 0 0 0 0 0 0 0 0 0 6 6 0 0 0 6 0 0 0 6 
6 0 0 0 6 6 0 6 6 0 0 0 0 0 0 0 0 0 0 0 0 0 0 0 6 6 0 0 0 0 0 0 0 0 0 0 0 0 0 0 0 6 6 0 6 6 0 0 0 6 
6 0 0 0 0 6 6 6 0 0 0 6 6 6 6 15 0 0 0 0 0 0 6 6 6 6 6 6 0 0 0 0 0 0 15 6 6 6 6 0 0 0 6 6 6 0 0 0 0 6 
6 0 0 7 7 0 0 0 0 0 6 6 0 0 6 6 6 6 13 6 6 6 6 0 0 0 0 6 6 6 6 13 6 6 6 6 0 0 6 6 0 0 0 0 0 7 7 0 0 6 
6 0 6 6 7 0 0 0 0 6 6 0 0 0 0 0 0 0 0 0 0 0 0 0 0 0 0 0 0 0 0 0 0 0 0 0 0 0 0 6 6 0 0 0 0 7 6 6 0 6 
6 0 10 6 6 0 0 0 0 6 0 0 0 8 0 0 0 0 0 0 6 6 6 0 0 0 0 6 6 6 0 0 0 0 0 0 8 0 0 0 6 0 0 0 0 6 6 10 0 6 
6 0 0 0 0 0 0 0 0 6 6 0 0 0 0 0 0 0 0 0 0 0 6 0 0 0 0 6 0 0 0 0 0 0 0 0 0 0 0 6 6 0 0 0 0 0 0 0 0 6 
6 0 0 0 0 0 6 7 7 0 6 6 6 7 7 7 0 0 0 0 0 0 6 0 0 0 0 6 0 0 0 0 0 0 7 7 7 6 6 6 0 7 7 6 0 0 0 0 0 6 
6 0 0 0 0 0 6 6 7 0 0 0 6 6 6 6 6 6 6 6 0 0 0 0 0 0 0 0 0 0 6 6 6 6 6 6 6 6 0 0 0 7 6 6 0 0 0 0 0 6 
6 0 0 0 0 0 9 6 0 0 0 0 0 0 0 0 0 0 0 6 11 6 6 6 6 6 6 6 6 11 6 0 0 0 0 0 0 0 0 0 0 0 6 0 0 0 0 0 0 6 
6 0 0 0 0 0 0 0 0 0 0 0 0 0 0 0 0 0 0 0 0 0 0 0 0 0 0 0 0 0 0 0 0 0 0 0 0 0 0 0 0 0 0 0 0 0 0 0 0 6 
6 6 6 6 6 6 6 6 6 6 6 6 6 6 6 6 6 6 6 6 6 6 6 6 6 6 6 6 6 6 6 6 6 6 6 6 6 6 6 6 6 6 6 6 6 6 6 6 6 6 
